F 255  , 95  , 88
R 1920 1080
C 55, 55, 5

11
            11
   11
11    11
1111 
                     11
11