F 255  , 95  , 28
R 1920 1080
C 55, 55, 5

1111
101111
1120N1
 1111
