F 255  , 95  , 88
R 1920 1080
C 55, 55, 5

111
101111
1100N1
 1111

111
1111