F 255  , 95  , 28
R 1920 1080
C 55, 55, 5

111
101111
11h0N1
 1111
