F 255  , 95  , 28
R 1920 1080
C 55, 55, 5

 11111    11111 
1100001  1000011
1000000110000001
1000000110000001
1000000110000001
1000000110000001
1100001  1000011
 11111    11111 
