F 255  , 95  , 28
R 1920 1080
C 55, 55, 5

 111111   11111 
11000011 1000011
1000000110000001
1000000110000001
1000000110000001
100N000110000001
11000011 1000011
 111111   11111 
