R 1200 800
NO ./textures/north1.xpm
WE ./textures/west2.xpm
SO ./textures/south1.xpm
EA ./textures/east2.xpm
S ./textures/tonneau.xpm
F 95,255,218
C 163,95,255


        1111111111111111111111111
        100000S000110000000000001
        1011020001110000002000001
        1001000000000000000000001
111111111011000001110000000000001
100000000011000001110111111111111
11110111111111011100000010001
11110111111111011101010010001
11000001110101011100000010001
10002001 10000001100000000001
10000001110000001101010010001
1100000111010101111101110000111
11110111 1110101 101111010001
11111111 1111111 111111111111