R 1200 800
NO ./textures/red.xpm
WE ./textures/purplestone.xpm
SO ./textures/bluestone.xpm
EA ./textures/greystone.xpm
S ./textures/tonneau.xpm
F 100,20,0
C 0,30,0


   11111111      11111111   
  1100000011    1100000011  
 110000000011  110000000011 
1100000000001111000000000011
1120002000001111000020000011
1100000020000000000000000011
1100000000001111000000200011
 110000000011  110000000011 
  1100000011    1100000011  
   11001111      11110011   
   11001111      11110011   
  1100000011    1100000011  
 110000000011  110000000011 
1100000000001111000000000011
1100000000000000000000000011
110000N000000000000020000011
1100000000001111000000000011
 110000000011  110000000011 
  1100000011    1100000011  
   11111111      11111111   