R 1200 800
NO ./textures/red.xpm
WE ./textures/purplestone.xpm
SO ./textures/bluestone.xpm
EA ./textures/greystone.xpm
S ./textures/tonneau.xpm
F 100,20,0
C 0,30,0
111111
122221
122001
1220N1
111111