R 800 300
NO ./textures/red.xpm
WE ./textures/purplestone.xpm
SO ./textures/bluestone.xpm
EA ./textures/greystone.xpm
S ./textures/tonneau.xpm
F 100,20,0
C 0,30,0

                        
   111   111 111  111   
   101   101 101  101   
   101   101 101  101   
   101   101 101  101   
   101   101 101  101   
   101111101110111101   
   100000111000000001   
   1000021 1000000001   
   1000001110S0000001   
   111111111111111111   
                        

