R 1920 1080
NO ./textures/red.xpm
WE ./textures/purplestone.xpm
SO ./textures/bluestone.xpm
EA ./textures/greystone.xpm
S ./textures/tonneau.xpm
F -255, 24, 0
C 9, 73,109
111111
100101
102001
1100N1
111111