NO 800 300
R ./textures/red.xpm
SO ./textures/purplestone.xpm
WE ./textures/bluestone.xpm
EA ./textures/greystone.xpm
S ./textures/tonneau.xpm
F 100,20,0
C 0,30,0
111111
100101
102001
1100N1
111111