R 800 300
NO ./textures/red.xpm
WE ./textures/purplestone.xpm
SO ./textures/bluestone.xpm
EA ./textures/greystone.xpm
S ./textures/tonneau.xpm
F 100,20,0
C 0,30,0
1111
1001
1101
 101
 111
  1111111
  1000001
  10000N111111111111
  100000000000000001
  111111111110000001
            10000001
            10000011
            1000011
            100011
            10011
            1011
            111
            11
            10