R 1920 1080
NO ./textures/red.xpm
WE ./textures/purplestone.xpm
SO ./textures/bluestone.xpm
EA ./textures/greystone.xpm
S ./textures/tonneau.xpm
F 110, 24, 0
C 42, 42, 42,42
111111
100101
102001
1100N1
111111